WWWWWWWWWW
W........W
W.W.W.W.WW
W.W....W.E
WWWWWWWWWW